{
	"grid" : [
			[-1, -1, -1, -1, -1, -1, -1, -1, -1, -1, -1, -1, -1, -1, -1, -1, -1, -1],
			[-1,  0,  0,  0,  0,  0,  0, -1,  0, -1,  0,  0,  0,  0,  0,  0,  0, -1],
			[-1,  0, -1,  0, -1, -1,  0,  0,  0, -1,  0,  0,  0,  0, -1,  0,  0, -1],
			[-1,  0,  0,  0, -1, -1,  0, -1,  0,  0,  0,  0,  0,  0, -1, -1, -1, -1],
			[-1,  0, -1,  0, -1, -1,  0, -1,  0, -1,  0,  0,  0,  0, -1,  0,  0, -1],
			[-1,  0,  0,  0,  0,  0,  0, -1,  0, -1,  0,  0,  0,  0,  0,  0,  0, -1],
			[-1, -1, -1, -1, -1, -1, -1, -1,  0, -1, -1,  0,  0, -1, -1, -1, -1, -1],
			[-1,  0,  0,  0,  0,  0,  0,  0,  0, -1, -1,  0,  0, -1, -1, -1, -1, -1],
			[-1,  0, -1,  0, -1,  0, -1, -1, -1, -1, -1,  0,  0,  0,  0,  0, -1, -1],
			[-1,  0, -1,  0,  0,  0, -1,  0,  0,  0,  0,  0,  0,  0,  0,  0, -1, -1],
			[-1,  0, -1, -1, -1, -1, -1,  0, -1, -1, -1,  0,  0,  0,  0,  0, -1, -1],
			[-1,  0, -1,  0,  0,  0, -1,  0, -1, -1, -1, -1, -1, -1, -1, -1, -1, -1],
			[-1,  0,  0,  0,  0,  0,  0,  0,  0, -1, -1, -1, -1, -1, -1, -1, -1, -1],
			[-1,  0, -1,  0,  0,  0, -1,  0,  0, -1, -1, -1, -1, -1, -1, -1, -1, -1],
			[-1, -1, -1, -1, -1, -1, -1, -1, -1, -1, -1, -1, -1, -1, -1, -1, -1, -1]
		],
	"tileMap" : {
			"0" : "res/sprites/tiles/greenSquare.png",
			"1" : "res/sprites/tiles/graySquare.png"
		},
	"tileWidth" : 32,
	"tileHeight" : 32
}